"filename", "language", "XML", "JSON", "C#", "ApexLog", "TypeScript JSX", "comment", "blank", "total"
"/Users/teddysiker/Desktop/Coding/GitHub/herbicide/Herbicide/Assembly-CSharp.csproj", "XML", 3, 0, 0, 0, 0, 0, 0, 3
"/Users/teddysiker/Desktop/Coding/GitHub/herbicide/Herbicide/Assets/Levels/level1.json", "JSON", 0, 3, 0, 0, 0, 0, 0, 3
"/Users/teddysiker/Desktop/Coding/GitHub/herbicide/Herbicide/Assets/Scripts/Controllers/AcornController.cs", "C#", 0, 0, -3, 0, 0, -3, 0, -6
"/Users/teddysiker/Desktop/Coding/GitHub/herbicide/Herbicide/Assets/Scripts/Controllers/BasicTreeSeedController.cs", "C#", 0, 0, 69, 0, 0, 57, 22, 148
"/Users/teddysiker/Desktop/Coding/GitHub/herbicide/Herbicide/Assets/Scripts/Controllers/BearController.cs", "C#", 0, 0, -1, 0, 0, -4, -1, -6
"/Users/teddysiker/Desktop/Coding/GitHub/herbicide/Herbicide/Assets/Scripts/Controllers/BombController.cs", "C#", 0, 0, 0, 0, 0, -2, -1, -3
"/Users/teddysiker/Desktop/Coding/GitHub/herbicide/Herbicide/Assets/Scripts/Controllers/ControllerController.cs", "C#", 0, 0, 4, 0, 0, 0, 0, 4
"/Users/teddysiker/Desktop/Coding/GitHub/herbicide/Herbicide/Assets/Scripts/Controllers/DefenderController.cs", "C#", 0, 0, 5, 0, 0, 9, 6, 20
"/Users/teddysiker/Desktop/Coding/GitHub/herbicide/Herbicide/Assets/Scripts/Controllers/FlooringController.cs", "C#", 0, 0, 13, 0, 0, 27, 6, 46
"/Users/teddysiker/Desktop/Coding/GitHub/herbicide/Herbicide/Assets/Scripts/Controllers/HedgehogController.cs", "C#", 0, 0, 91, 0, 0, 32, 16, 139
"/Users/teddysiker/Desktop/Coding/GitHub/herbicide/Herbicide/Assets/Scripts/Controllers/LevelController.cs", "C#", 0, 0, 1, 0, 0, 0, 0, 1
"/Users/teddysiker/Desktop/Coding/GitHub/herbicide/Herbicide/Assets/Scripts/Controllers/MobController.cs", "C#", 0, 0, 7, 0, 0, 1, 1, 9
"/Users/teddysiker/Desktop/Coding/GitHub/herbicide/Herbicide/Assets/Scripts/Controllers/ProjectileController.cs", "C#", 0, 0, 3, 0, 0, 0, 0, 3
"/Users/teddysiker/Desktop/Coding/GitHub/herbicide/Herbicide/Assets/Scripts/Controllers/SquirrelController.cs", "C#", 0, 0, -1, 0, 0, -4, 0, -5
"/Users/teddysiker/Desktop/Coding/GitHub/herbicide/Herbicide/Assets/Scripts/Factories/BasicTreeSeedFactory.cs", "C#", 0, 0, 26, 0, 0, 35, 11, 72
"/Users/teddysiker/Desktop/Coding/GitHub/herbicide/Herbicide/Assets/Scripts/Factories/FlooringFactory.cs", "C#", 0, 0, 3, 0, 0, 7, 2, 12
"/Users/teddysiker/Desktop/Coding/GitHub/herbicide/Herbicide/Assets/Scripts/Loading/LayerData.cs", "C#", 0, 0, 1, 0, 0, 2, 2, 5
"/Users/teddysiker/Desktop/Coding/GitHub/herbicide/Herbicide/Assets/Scripts/Loading/ObjectData.cs", "C#", 0, 0, 12, 0, 0, 9, 4, 25
"/Users/teddysiker/Desktop/Coding/GitHub/herbicide/Herbicide/Assets/Scripts/Loading/TiledData.cs", "C#", 0, 0, -13, 0, 0, -9, -2, -24
"/Users/teddysiker/Desktop/Coding/GitHub/herbicide/Herbicide/Assets/Scripts/Managers/TileGrid.cs", "C#", 0, 0, 22, 0, 0, 17, 5, 44
"/Users/teddysiker/Desktop/Coding/GitHub/herbicide/Herbicide/Assets/Scripts/Models/Flooring.cs", "C#", 0, 0, -3, 0, 0, -5, -1, -9
"/Users/teddysiker/Desktop/Coding/GitHub/herbicide/Herbicide/Assets/Scripts/Models/Hedgehog.cs", "C#", 0, 0, 1, 0, 0, 4, 1, 6
"/Users/teddysiker/Desktop/Coding/GitHub/herbicide/Herbicide/Assets/Scripts/Models/Model.cs", "C#", 0, 0, 7, 0, 0, 10, 2, 19
"/Users/teddysiker/Desktop/Coding/GitHub/herbicide/Herbicide/Assets/Scripts/Models/PlaceableObject.cs", "C#", 0, 0, -1, 0, 0, -6, -1, -8
"/Users/teddysiker/Desktop/Coding/GitHub/herbicide/Herbicide/Assets/Scripts/Models/SoilFlooring.cs", "C#", 0, 0, 1, 0, 0, 5, 1, 7
"/Users/teddysiker/Desktop/Coding/GitHub/herbicide/Herbicide/Assets/Scripts/Models/Squirrel.cs", "C#", 0, 0, 0, 0, 0, -4, -3, -7
"/Users/teddysiker/Desktop/Coding/GitHub/herbicide/Herbicide/Assets/Scripts/Models/Tile.cs", "C#", 0, 0, 13, 0, 0, 13, 2, 28
"/Users/teddysiker/Desktop/Coding/GitHub/herbicide/Herbicide/Logs/AssetImportWorker0-prev.log", "ApexLog", 0, 0, 0, -7538, 0, 0, -127, -7665
"/Users/teddysiker/Desktop/Coding/GitHub/herbicide/Herbicide/Logs/AssetImportWorker0.log", "ApexLog", 0, 0, 0, 771, 0, 0, 15, 786
"/Users/teddysiker/Desktop/Coding/GitHub/herbicide/Herbicide/Logs/AssetImportWorker1-prev.log", "ApexLog", 0, 0, 0, -7112, 0, 0, -127, -7239
"/Users/teddysiker/Desktop/Coding/GitHub/herbicide/Herbicide/Logs/AssetImportWorker1.log", "ApexLog", 0, 0, 0, 837, 0, 0, 15, 852
"/Users/teddysiker/Desktop/Coding/GitHub/herbicide/Herbicide/Logs/AssetImportWorker2-prev.log", "ApexLog", 0, 0, 0, -1601, 0, 0, -29, -1630
"/Users/teddysiker/Desktop/Coding/GitHub/herbicide/Herbicide/Logs/AssetImportWorker3-prev.log", "ApexLog", 0, 0, 0, -1601, 0, 0, -29, -1630
"/Users/teddysiker/Desktop/Coding/GitHub/herbicide/Herbicide/Logs/shadercompiler-AssetImportWorker0.log", "ApexLog", 0, 0, 0, 2, 0, 0, 1, 3
"/Users/teddysiker/Desktop/Coding/GitHub/herbicide/Herbicide/Tiled/Tilemaps/level1.tmx", "XML", -15, 0, 0, 0, 0, 0, 0, -15
"/Users/teddysiker/Desktop/Coding/GitHub/herbicide/Herbicide/Tiled/Tilesets/Soil.tsx", "TypeScript JSX", 0, 0, 0, 0, 80, 0, 0, 80
"Total", "-", -12, 3, 257, -16242, 80, 191, -209, -15932