"filename", "language", "JSON", "XML", "C#", "ApexLog", "TypeScript JSX", "comment", "blank", "total"
"/Users/teddysiker/Desktop/Coding/GitHub/herbicide/Herbicide/Assembly-CSharp.csproj", "XML", 0, -1, 0, 0, 0, 0, 0, -1
"/Users/teddysiker/Desktop/Coding/GitHub/herbicide/Herbicide/Assets/Levels/level0.json", "JSON", -195, 0, 0, 0, 0, 0, 0, -195
"/Users/teddysiker/Desktop/Coding/GitHub/herbicide/Herbicide/Assets/Levels/level1.json", "JSON", 297, 0, 0, 0, 0, 0, 0, 297
"/Users/teddysiker/Desktop/Coding/GitHub/herbicide/Herbicide/Assets/Scripts/Controllers/BombController.cs", "C#", 0, 0, -1, 0, 0, 0, 0, -1
"/Users/teddysiker/Desktop/Coding/GitHub/herbicide/Herbicide/Assets/Scripts/Controllers/ButterflyController.cs", "C#", 0, 0, -8, 0, 0, 0, 0, -8
"/Users/teddysiker/Desktop/Coding/GitHub/herbicide/Herbicide/Assets/Scripts/Controllers/CollectableController.cs", "C#", 0, 0, 34, 0, 0, 41, 12, 87
"/Users/teddysiker/Desktop/Coding/GitHub/herbicide/Herbicide/Assets/Scripts/Controllers/ControllerController.cs", "C#", 0, 0, 56, 0, 0, -3, 6, 59
"/Users/teddysiker/Desktop/Coding/GitHub/herbicide/Herbicide/Assets/Scripts/Controllers/DefenderController.cs", "C#", 0, 0, 2, 0, 0, 0, 1, 3
"/Users/teddysiker/Desktop/Coding/GitHub/herbicide/Herbicide/Assets/Scripts/Controllers/DewController.cs", "C#", 0, 0, 7, 0, 0, 0, 2, 9
"/Users/teddysiker/Desktop/Coding/GitHub/herbicide/Herbicide/Assets/Scripts/Controllers/EconomyController.cs", "C#", 0, 0, 9, 0, 0, 7, 2, 18
"/Users/teddysiker/Desktop/Coding/GitHub/herbicide/Herbicide/Assets/Scripts/Controllers/EnemyController.cs", "C#", 0, 0, -4, 0, 0, -15, -10, -29
"/Users/teddysiker/Desktop/Coding/GitHub/herbicide/Herbicide/Assets/Scripts/Controllers/InputController.cs", "C#", 0, 0, 4, 0, 0, 4, 1, 9
"/Users/teddysiker/Desktop/Coding/GitHub/herbicide/Herbicide/Assets/Scripts/Controllers/InventoryController.cs", "C#", 0, 0, -7, 0, 0, 7, 0, 0
"/Users/teddysiker/Desktop/Coding/GitHub/herbicide/Herbicide/Assets/Scripts/Controllers/KudzuController.cs", "C#", 0, 0, 147, 0, 0, 65, 37, 249
"/Users/teddysiker/Desktop/Coding/GitHub/herbicide/Herbicide/Assets/Scripts/Controllers/LevelController.cs", "C#", 0, 0, -4, 0, 0, -7, 2, -9
"/Users/teddysiker/Desktop/Coding/GitHub/herbicide/Herbicide/Assets/Scripts/Controllers/MobController.cs", "C#", 0, 0, 20, 0, 0, 17, 5, 42
"/Users/teddysiker/Desktop/Coding/GitHub/herbicide/Herbicide/Assets/Scripts/Controllers/ModelController.cs", "C#", 0, 0, 13, 0, 0, 34, 8, 55
"/Users/teddysiker/Desktop/Coding/GitHub/herbicide/Herbicide/Assets/Scripts/Controllers/PlacementController.cs", "C#", 0, 0, -6, 0, 0, 1, -1, -6
"/Users/teddysiker/Desktop/Coding/GitHub/herbicide/Herbicide/Assets/Scripts/Controllers/ShopBoatController.cs", "C#", 0, 0, 75, 0, 0, 22, 20, 117
"/Users/teddysiker/Desktop/Coding/GitHub/herbicide/Herbicide/Assets/Scripts/Controllers/SquirrelController.cs", "C#", 0, 0, 6, 0, 0, 7, 2, 15
"/Users/teddysiker/Desktop/Coding/GitHub/herbicide/Herbicide/Assets/Scripts/Controllers/TreeController.cs", "C#", 0, 0, 2, 0, 0, 0, 1, 3
"/Users/teddysiker/Desktop/Coding/GitHub/herbicide/Herbicide/Assets/Scripts/DataStructures/ModelCounts.cs", "C#", 0, 0, 23, 0, 0, 26, 6, 55
"/Users/teddysiker/Desktop/Coding/GitHub/herbicide/Herbicide/Assets/Scripts/DataStructures/ModelType.cs", "C#", 0, 0, 1, 0, 0, 0, 0, 1
"/Users/teddysiker/Desktop/Coding/GitHub/herbicide/Herbicide/Assets/Scripts/DataStructures/PathfindingCache.cs", "C#", 0, 0, 47, 0, 0, 44, 14, 105
"/Users/teddysiker/Desktop/Coding/GitHub/herbicide/Herbicide/Assets/Scripts/DataStructures/ShopModel.cs", "C#", 0, 0, 0, 0, 0, 0, -1, -1
"/Users/teddysiker/Desktop/Coding/GitHub/herbicide/Herbicide/Assets/Scripts/Factories/AcornFactory.cs", "C#", 0, 0, 26, 0, 0, 35, 12, 73
"/Users/teddysiker/Desktop/Coding/GitHub/herbicide/Herbicide/Assets/Scripts/Factories/BasicTreeFactory.cs", "C#", 0, 0, 26, 0, 0, 35, 11, 72
"/Users/teddysiker/Desktop/Coding/GitHub/herbicide/Herbicide/Assets/Scripts/Factories/BombFactory.cs", "C#", 0, 0, 29, 0, 0, 42, 13, 84
"/Users/teddysiker/Desktop/Coding/GitHub/herbicide/Herbicide/Assets/Scripts/Factories/BombSplatFactory.cs", "C#", 0, 0, 26, 0, 0, 35, 11, 72
"/Users/teddysiker/Desktop/Coding/GitHub/herbicide/Herbicide/Assets/Scripts/Factories/ButterflyFactory.cs", "C#", 0, 0, 35, 0, 0, 55, 17, 107
"/Users/teddysiker/Desktop/Coding/GitHub/herbicide/Herbicide/Assets/Scripts/Factories/CollectableFactory.cs", "C#", 0, 0, -27, 0, 0, -19, -7, -53
"/Users/teddysiker/Desktop/Coding/GitHub/herbicide/Herbicide/Assets/Scripts/Factories/DefenderFactory.cs", "C#", 0, 0, -64, 0, 0, -62, -26, -152
"/Users/teddysiker/Desktop/Coding/GitHub/herbicide/Herbicide/Assets/Scripts/Factories/DewFactory.cs", "C#", 0, 0, 26, 0, 0, 35, 11, 72
"/Users/teddysiker/Desktop/Coding/GitHub/herbicide/Herbicide/Assets/Scripts/Factories/EnemyFactory.cs", "C#", 0, 0, -81, 0, 0, -44, -17, -142
"/Users/teddysiker/Desktop/Coding/GitHub/herbicide/Herbicide/Assets/Scripts/Factories/FlooringFactory.cs", "C#", 0, 0, 0, 0, 0, 0, -1, -1
"/Users/teddysiker/Desktop/Coding/GitHub/herbicide/Herbicide/Assets/Scripts/Factories/HazardFactory.cs", "C#", 0, 0, -26, 0, 0, -18, -6, -50
"/Users/teddysiker/Desktop/Coding/GitHub/herbicide/Herbicide/Assets/Scripts/Factories/KudzuFactory.cs", "C#", 0, 0, 146, 0, 0, 160, 52, 358
"/Users/teddysiker/Desktop/Coding/GitHub/herbicide/Herbicide/Assets/Scripts/Factories/NexusFactory.cs", "C#", 0, 0, 25, 0, 0, 30, 11, 66
"/Users/teddysiker/Desktop/Coding/GitHub/herbicide/Herbicide/Assets/Scripts/Factories/NexusHoleFactory.cs", "C#", 0, 0, 26, 0, 0, 32, 11, 69
"/Users/teddysiker/Desktop/Coding/GitHub/herbicide/Herbicide/Assets/Scripts/Factories/ProjectileFactory.cs", "C#", 0, 0, -34, 0, 0, -23, -8, -65
"/Users/teddysiker/Desktop/Coding/GitHub/herbicide/Herbicide/Assets/Scripts/Factories/ShopBoatFactory.cs", "C#", 0, 0, 29, 0, 0, 43, 13, 85
"/Users/teddysiker/Desktop/Coding/GitHub/herbicide/Herbicide/Assets/Scripts/Factories/SquirrelFactory.cs", "C#", 0, 0, 72, 0, 0, 69, 23, 164
"/Users/teddysiker/Desktop/Coding/GitHub/herbicide/Herbicide/Assets/Scripts/Factories/StructureFactory.cs", "C#", 0, 0, -32, 0, 0, -24, -11, -67
"/Users/teddysiker/Desktop/Coding/GitHub/herbicide/Herbicide/Assets/Scripts/Factories/TreeFactory.cs", "C#", 0, 0, -41, 0, 0, -43, -17, -101
"/Users/teddysiker/Desktop/Coding/GitHub/herbicide/Herbicide/Assets/Scripts/Loading/ObjectData.cs", "C#", 0, 0, 21, 0, 0, 11, 4, 36
"/Users/teddysiker/Desktop/Coding/GitHub/herbicide/Herbicide/Assets/Scripts/Managers/EnemyManager.cs", "C#", 0, 0, 17, 0, 0, 9, 4, 30
"/Users/teddysiker/Desktop/Coding/GitHub/herbicide/Herbicide/Assets/Scripts/Managers/ShopManager.cs", "C#", 0, 0, 51, 0, 0, 31, 13, 95
"/Users/teddysiker/Desktop/Coding/GitHub/herbicide/Herbicide/Assets/Scripts/Managers/TileGrid.cs", "C#", 0, 0, 71, 0, 0, 3, 11, 85
"/Users/teddysiker/Desktop/Coding/GitHub/herbicide/Herbicide/Assets/Scripts/Models/Acorn.cs", "C#", 0, 0, 3, 0, 0, 17, 4, 24
"/Users/teddysiker/Desktop/Coding/GitHub/herbicide/Herbicide/Assets/Scripts/Models/BasicTree.cs", "C#", 0, 0, 6, 0, 0, 15, 3, 24
"/Users/teddysiker/Desktop/Coding/GitHub/herbicide/Herbicide/Assets/Scripts/Models/Bomb.cs", "C#", 0, 0, 3, 0, 0, 17, 4, 24
"/Users/teddysiker/Desktop/Coding/GitHub/herbicide/Herbicide/Assets/Scripts/Models/Butterfly.cs", "C#", 0, 0, 6, 0, 0, 12, 3, 21
"/Users/teddysiker/Desktop/Coding/GitHub/herbicide/Herbicide/Assets/Scripts/Models/Collectable.cs", "C#", 0, 0, -5, 0, 0, -5, 0, -10
"/Users/teddysiker/Desktop/Coding/GitHub/herbicide/Herbicide/Assets/Scripts/Models/Defender.cs", "C#", 0, 0, -15, 0, 0, -9, -3, -27
"/Users/teddysiker/Desktop/Coding/GitHub/herbicide/Herbicide/Assets/Scripts/Models/Dew.cs", "C#", 0, 0, 3, 0, 0, 17, 4, 24
"/Users/teddysiker/Desktop/Coding/GitHub/herbicide/Herbicide/Assets/Scripts/Models/Enemy.cs", "C#", 0, 0, -1, 0, 0, -3, -1, -5
"/Users/teddysiker/Desktop/Coding/GitHub/herbicide/Herbicide/Assets/Scripts/Models/Flooring.cs", "C#", 0, 0, 4, 0, 0, 5, 1, 10
"/Users/teddysiker/Desktop/Coding/GitHub/herbicide/Herbicide/Assets/Scripts/Models/GrassTile.cs", "C#", 0, 0, 1, 0, 0, 3, 2, 6
"/Users/teddysiker/Desktop/Coding/GitHub/herbicide/Herbicide/Assets/Scripts/Models/Hazard.cs", "C#", 0, 0, -1, 0, 0, -3, -1, -5
"/Users/teddysiker/Desktop/Coding/GitHub/herbicide/Herbicide/Assets/Scripts/Models/Kudzu.cs", "C#", 0, 0, 0, 0, 0, -4, 0, -4
"/Users/teddysiker/Desktop/Coding/GitHub/herbicide/Herbicide/Assets/Scripts/Models/Model.cs", "C#", 0, 0, 4, 0, 0, 14, 4, 22
"/Users/teddysiker/Desktop/Coding/GitHub/herbicide/Herbicide/Assets/Scripts/Models/Nexus.cs", "C#", 0, 0, 1, 0, 0, 3, 0, 4
"/Users/teddysiker/Desktop/Coding/GitHub/herbicide/Herbicide/Assets/Scripts/Models/PlaceableObject.cs", "C#", 0, 0, -2, 0, 0, -8, -2, -12
"/Users/teddysiker/Desktop/Coding/GitHub/herbicide/Herbicide/Assets/Scripts/Models/Projectile.cs", "C#", 0, 0, -9, 0, 0, -15, -3, -27
"/Users/teddysiker/Desktop/Coding/GitHub/herbicide/Herbicide/Assets/Scripts/Models/SeedToken.cs", "C#", 0, 0, -16, 0, 0, -21, -5, -42
"/Users/teddysiker/Desktop/Coding/GitHub/herbicide/Herbicide/Assets/Scripts/Models/ShopBoat.cs", "C#", 0, 0, 32, 0, 0, 87, 12, 131
"/Users/teddysiker/Desktop/Coding/GitHub/herbicide/Herbicide/Assets/Scripts/Models/ShoreTile.cs", "C#", 0, 0, 1, 0, 0, 3, 1, 5
"/Users/teddysiker/Desktop/Coding/GitHub/herbicide/Herbicide/Assets/Scripts/Models/SoilFlooring.cs", "C#", 0, 0, 1, 0, 0, 3, 1, 5
"/Users/teddysiker/Desktop/Coding/GitHub/herbicide/Herbicide/Assets/Scripts/Models/Squirrel.cs", "C#", 0, 0, 6, 0, 0, 15, 4, 25
"/Users/teddysiker/Desktop/Coding/GitHub/herbicide/Herbicide/Assets/Scripts/Models/Structure.cs", "C#", 0, 0, -1, 0, 0, -3, -1, -5
"/Users/teddysiker/Desktop/Coding/GitHub/herbicide/Herbicide/Assets/Scripts/Models/Tile.cs", "C#", 0, 0, 4, 0, 0, 5, 1, 10
"/Users/teddysiker/Desktop/Coding/GitHub/herbicide/Herbicide/Assets/Scripts/Models/Tree.cs", "C#", 0, 0, -23, 0, 0, -32, -8, -63
"/Users/teddysiker/Desktop/Coding/GitHub/herbicide/Herbicide/Assets/Scripts/Models/WaterTile.cs", "C#", 0, 0, 1, 0, 0, 3, 1, 5
"/Users/teddysiker/Desktop/Coding/GitHub/herbicide/Herbicide/Assets/Scripts/Scriptables/CollectableScriptable.cs", "C#", 0, 0, -18, 0, 0, -18, -6, -42
"/Users/teddysiker/Desktop/Coding/GitHub/herbicide/Herbicide/Assets/Scripts/Scriptables/DefenderScriptable.cs", "C#", 0, 0, -89, 0, 0, -66, -21, -176
"/Users/teddysiker/Desktop/Coding/GitHub/herbicide/Herbicide/Assets/Scripts/Scriptables/EnemyScriptable.cs", "C#", 0, 0, -234, 0, 0, -177, -50, -461
"/Users/teddysiker/Desktop/Coding/GitHub/herbicide/Herbicide/Assets/Scripts/Scriptables/HazardScriptable.cs", "C#", 0, 0, -18, 0, 0, -18, -5, -41
"/Users/teddysiker/Desktop/Coding/GitHub/herbicide/Herbicide/Assets/Scripts/Scriptables/ProjectileScriptable.cs", "C#", 0, 0, -21, 0, 0, -25, -11, -57
"/Users/teddysiker/Desktop/Coding/GitHub/herbicide/Herbicide/Assets/Scripts/Scriptables/ShopScriptable.cs", "C#", 0, 0, 9, 0, 0, 21, 6, 36
"/Users/teddysiker/Desktop/Coding/GitHub/herbicide/Herbicide/Assets/Scripts/Scriptables/StructureScriptable.cs", "C#", 0, 0, -19, 0, 0, -18, -6, -43
"/Users/teddysiker/Desktop/Coding/GitHub/herbicide/Herbicide/Assets/Scripts/View/SceneController.cs", "C#", 0, 0, 9, 0, 0, 16, 6, 31
"/Users/teddysiker/Desktop/Coding/GitHub/herbicide/Herbicide/Logs/AssetImportWorker0-prev.log", "ApexLog", 0, 0, 0, -3874, 0, 0, -64, -3938
"/Users/teddysiker/Desktop/Coding/GitHub/herbicide/Herbicide/Logs/AssetImportWorker0.log", "ApexLog", 0, 0, 0, 4420, 0, 0, 81, 4501
"/Users/teddysiker/Desktop/Coding/GitHub/herbicide/Herbicide/Logs/AssetImportWorker1-prev.log", "ApexLog", 0, 0, 0, -3544, 0, 0, -64, -3608
"/Users/teddysiker/Desktop/Coding/GitHub/herbicide/Herbicide/Logs/AssetImportWorker1.log", "ApexLog", 0, 0, 0, 4512, 0, 0, 81, 4593
"/Users/teddysiker/Desktop/Coding/GitHub/herbicide/Herbicide/Logs/shadercompiler-AssetImportWorker0.log", "ApexLog", 0, 0, 0, 2, 0, 0, 1, 3
"/Users/teddysiker/Desktop/Coding/GitHub/herbicide/Herbicide/Tiled/Tilemaps/level0.tmx", "XML", 0, -26, 0, 0, 0, 0, 0, -26
"/Users/teddysiker/Desktop/Coding/GitHub/herbicide/Herbicide/Tiled/Tilemaps/level1.json", "JSON", 316, 0, 0, 0, 0, 0, 0, 316
"/Users/teddysiker/Desktop/Coding/GitHub/herbicide/Herbicide/Tiled/Tilemaps/level1.tmx", "XML", 0, 116, 0, 0, 0, 0, 1, 117
"/Users/teddysiker/Desktop/Coding/GitHub/herbicide/Herbicide/Tiled/Tilesets/Markers.tsx", "TypeScript JSX", 0, 0, 0, 0, 6, 0, 0, 6
"Total", "-", 418, 89, 359, 1516, 6, 473, 201, 3062